{
  "width": 20,
  "height": 11,
  "tileWidth": 16,
  "tileHeight": 16,
  "tileset": "assets/images/tiles/basetiles.png",
  "layers": {
    "background": [
      2,2,2,2,2,2,2,2,2,2,2,2,2,2,2,2,2,2,2,2,
      2,2,2,2,2,2,2,2,2,2,2,2,2,2,2,2,2,2,2,2,
      2,2,2,2,2,2,2,2,2,2,2,2,2,2,2,2,2,2,2,2,
      2,2,2,2,2,2,2,2,2,2,2,2,2,2,2,2,2,2,2,2,
      2,2,2,2,2,2,2,2,2,2,2,2,2,2,2,2,2,2,2,2,
      2,2,2,2,2,2,2,2,2,2,2,2,2,2,2,2,2,2,2,2,
      2,2,2,2,2,2,2,2,2,2,2,2,2,2,2,2,2,2,2,2,
      2,2,2,2,2,2,2,2,2,2,2,2,2,2,2,2,2,2,2,2,
      2,2,2,2,2,2,2,2,2,2,2,2,2,2,2,2,2,2,2,2,
      2,2,2,2,2,2,2,2,2,2,2,2,2,2,2,2,2,2,2,2,
      2,2,2,2,2,2,2,2,2,2,2,2,2,2,2,2,2,2,2,2
    ],
    "objects": [
      4,4,4,4,4,4,4,4,4,4,4,4,4,4,4,4,4,4,4,4,
      4,0,0,0,0,0,0,0,0,0,0,0,0,0,0,0,0,0,0,4,
      4,0,0,0,0,0,0,0,0,0,0,0,0,0,0,0,0,0,0,4,
      4,0,0,0,0,0,0,0,0,0,0,0,0,0,0,0,0,0,0,4,
      4,0,0,0,0,0,0,0,0,0,0,0,0,0,0,0,0,0,0,4,
      4,0,0,5,0,0,0,0,0,0,3,0,0,0,0,0,0,1,0,4,
      4,0,0,0,0,0,0,0,0,0,0,0,0,0,0,0,0,0,0,4,
      4,0,0,0,0,0,0,0,0,0,0,0,0,0,0,0,0,0,0,4,
      4,0,0,0,0,0,0,0,0,0,0,0,0,0,0,0,0,0,0,4,
      4,0,0,0,0,0,0,0,0,0,0,0,0,0,0,0,0,0,0,4,
      4,4,4,4,4,4,4,4,4,4,4,4,4,4,4,4,4,4,4,4
    ],
    "foreground": [
      0,0,0,0,0,0,0,0,0,0,0,0,0,0,0,0,0,0,0,0,
      0,0,0,0,0,0,0,0,0,0,0,0,0,0,0,0,0,0,0,0,
      0,0,0,0,0,0,0,0,0,0,0,0,0,0,0,0,0,0,0,0,
      0,0,0,0,0,0,0,0,0,0,0,0,0,0,0,0,0,0,0,0,
      0,0,0,0,0,0,0,0,0,0,0,0,0,0,0,0,0,0,0,0,
      0,0,0,0,0,0,0,0,0,0,0,0,0,0,0,0,0,0,0,0,
      0,0,0,0,0,0,0,0,0,0,0,0,0,0,0,0,0,0,0,0,
      0,0,0,0,0,0,0,0,0,0,0,0,0,0,0,0,0,0,0,0,
      0,0,0,0,0,0,0,0,0,0,0,0,0,0,0,0,0,0,0,0,
      0,0,0,0,0,0,0,0,0,0,0,0,0,0,0,0,0,0,0,0,
      0,0,0,0,0,0,0,0,0,0,0,0,0,0,0,0,0,0,0,0
    ]
  }
}
